_INDEX,HeroDamage:int,HeroArmor:int,HeroMagic:int,HeroMagicDef:int,CharacterDamage:int,CharacterArmor:int,CharacterMagicDef:int
0,10,10,0,0,5,5,0
1,10,10,5,5,5,5,5
2,15,15,5,5,10,10,5
3,15,15,10,10,10,10,10
4,20,20,10,10,15,15,10
5,20,20,15,15,15,15,15
6,25,25,15,15,20,20,15
7,25,25,20,20,20,20,20
8,30,30,20,20,25,25,20
9,30,30,25,25,25,25,25
